======================
===========XXXXXXXXXXX
=XXXXXXXXXXXXXXXXXXXXX
XXXXXXXXXXXXXXXXXXXXXX
======================
======================
======================